1111111111111111111111111111111111111111111111111111111111111111111111
1000000000000000000000000000000000000000000000000000000000000000000001
1000111111111111111111111111111111111111111111111111111111111111110001
1000100000000000000000000000000000000000000000000000000000000000010001
1000100000000000000000000000000000000000000000000000000000000000010001
1000100006600660006660006666660006666600066600066666006660660000010001
1000100006000000000000000000000000000000000000000000000000060000010001
1000100000000000000000000000000000000000000000000000000000060000010001
1000100006000000660066666600666666600066666600066666600000000000010001
1000100000000000000000000000000000000000000000000000600000000000010001
1000100006000000600000000000000000000000000000000000000000060000010001
1000100006000000000000000000000000000000000000000000600000060000010001
1000100000000000600000000000000000000000000000000000600000000000010001
1000100006000000600000000000000000000000000000000000000000000000010001
1000100006000000000000000000000000000000000000000000600000060000010001
1000100000000000600000000000000000000000000000000000000000060000010001
1000100000000000660600066660006666000666666666660066600000000000010001
1000100006000000000000000000000000000000000000000000000000000000010001
1000100006000000000000000000000000000000000000000000000000060000010001
1000100006600660006660006666660006666600066600066666006660660000010001
1000100000000000000000000000000000000000000000000000000000000000010001
1000100000000000000000000000000000000000000000000000000000000000010001
1000111111111111111111111111111111111111111111111111111111111111110001
1000000000000000000000000000000000000000000000000000000000000000000001
1111111111111111111111111111111111111111111111111111111111111111111111
